00000000 s
0  0   0 0
00  0000 0
 0 00  000
 0 0   0 0
00000000  
0 0  0 0  
0 0 00 000
000  0   0
x 00000000