000 0 s 00000
0 0 0 0 0   0
0 0 0 0 000 0
0 0 0 0 0 0 0
0 0 0 0 0 0 0
0 0 0 0   0 0
0 000 00000 0
0 0         0
0 0 00000 000
0   0 0 0 0  
00000 0 0 0 0
0     0   0 0
0000x 0000000
SW